11111111111111111111
11000000000000000011
10000011111110000011
11000000011100000001
11111100000111100011
11100000111100001111
10001111100000111111
11111000000000000011
11100000001111111111
11111110000000011111
10000111100001111000
11100000000000000001
11111111110000001111
10000111111100000111
10000011110000011111
